TNFα	ABBREVIATION
mu opioid	FULL_NAME
histamine h3-receptor	FULL_NAME
neuropeptide Y	FULL_NAME
G protein coupled receptor 6 kinase	FULL_NAME
IL-1 beta	ABBREVIATION
NK-1 Receptor	FULL_NAME
cox1	ABBREVIATION
HTR4	ABBREVIATION
Dkk-3 DNA	FULL_NAME
TBK1	ABBREVIATION
phosphodiesterase 5	FULL_NAME
miR-584	ABBREVIATION
phosphodiesterase 9	FULL_NAME
urotensin II receptor	FULL_NAME
hNE	ABBREVIATION
sc-kit	ABBREVIATION
Drg11-responsive (dragon) gene	FULL_NAME
miR-181a	ABBREVIATION
Ezrin	FULL_NAME
glk	ABBREVIATION
anaplastic lymphoma kinase	FULL_NAME
AbI	ABBREVIATION
cdk	ABBREVIATION
activin receptor-like kinase 1	FULL_NAME
alpha-synuclein	FULL_NAME
activin receptor-like kinase 3	FULL_NAME
BCR	ABBREVIATION
PGP2α	ABBREVIATION
bactericidal permeability increasing protein	FULL_NAME
Aurora A kinase	FULL_NAME
MMP-2	ABBREVIATION
gpr 119	ABBREVIATION
MMP-1	ABBREVIATION
superoxide dismutase	FULL_NAME
cg3768	ABBREVIATION
Smac	ABBREVIATION
MMP-9	ABBREVIATION
SEP	ABBREVIATION
5HT2	ABBREVIATION
thymidylate synthase	FULL_NAME
Abl	ABBREVIATION
CRH-R1	ABBREVIATION
5HT4	ABBREVIATION
5HT6	ABBREVIATION
extracellular domain of human B7.1	FULL_NAME
kinase suppressor of Ras	FULL_NAME
CRH-R2	ABBREVIATION
programmed death protein 2	FULL_NAME
ZAP-70	ABBREVIATION
ADENOSINE A2a RECEPTOR	FULL_NAME
PDGFR	ABBREVIATION
B-Raf	ABBREVIATION
SREBP1	ABBREVIATION
LTA4H	ABBREVIATION
T cell protein tyrosine phosphatase	FULL_NAME
Mitotic kinesin-like protein-1	FULL_NAME
osteopontin	FULL_NAME
urokinase	FULL_NAME
human IGF-I	FULL_NAME
BET	ABBREVIATION
vascular endothelial growth factor (VEGF) receptor-2	NESTED
α7 nAChR	ABBREVIATION
K6b	ABBREVIATION
bmp-6	ABBREVIATION
K6a	ABBREVIATION
induction type nitric oxide synthetase	FULL_NAME
NF-Kappa B	ABBREVIATION
mimecan	FULL_NAME
PGD2	ABBREVIATION
Thrombin	FULL_NAME
deoxyhypusine synthase	FULL_NAME
prothrombin	FULL_NAME
Interleukin-1 beta	FULL_NAME
SMPD3	ABBREVIATION
MECP2	ABBREVIATION
TGF-beta	ABBREVIATION
paf	ABBREVIATION
serotonin reuptake	FULL_NAME
TSPO	ABBREVIATION
JAK2	ABBREVIATION
NF-kappa	ABBREVIATION
JAK3	ABBREVIATION
11βετα-hsd1	ABBREVIATION
Mdm2 protein	FULL_NAME
Human leucocyte antigen DR4 subtype protein	FULL_NAME
human somatostatin receptor type 5	FULL_NAME
DUSP5	ABBREVIATION
WT1 peptide	FULL_NAME
M4 receptor	FULL_NAME
cxcr3	ABBREVIATION
kappa opioid receptor	FULL_NAME
GIyTl	ABBREVIATION
cxcr2	ABBREVIATION
HBsAg	ABBREVIATION
Thymopentin	FULL_NAME
Cholesteryl ester transfer protein	FULL_NAME
DUSP6	ABBREVIATION
miR-556	ABBREVIATION
IDHIm	ABBREVIATION
Indoleamine 2,3-dioxygenase	FULL_NAME
SlP lyase	ABBREVIATION
human serum albumin	FULL_NAME
AOP-1	ABBREVIATION
BEC1 potassium channel	FULL_NAME
Aquaporin 4	FULL_NAME
PGES	ABBREVIATION
protein kinase C beta	FULL_NAME
pbr	ABBREVIATION
thrombin	FULL_NAME
Vascular Endothelial Growth Factor D	FULL_NAME
dopamine D4 receptor	FULL_NAME
Ep1	ABBREVIATION
chymase	FULL_NAME
Ep4	ABBREVIATION
blys	ABBREVIATION
transient receptor potential vanillin 3	FULL_NAME
Env	ABBREVIATION
NK-1 receptor	FULL_NAME
FGFR-1	ABBREVIATION
vascular cell adhesion molecule-1	FULL_NAME
EGFR	ABBREVIATION
human EGFR	FULL_NAME
EphrinA1	ABBREVIATION
2-type sodium galactosyl transporter	FULL_NAME
Edg-4	ABBREVIATION
dopamine d3 receptors	FULL_NAME
Edg-3	ABBREVIATION
Ghrelin	FULL_NAME
Tm4sf4	ABBREVIATION
Edg-2	ABBREVIATION
Edg-1	ABBREVIATION
flightless i	FULL_NAME
histamine h3	FULL_NAME
beta-defensin 3	FULL_NAME
PKM2	ABBREVIATION
3-hydroxy-3-methylglutaryl coenzyme A (HMG-CoA) reductase	NESTED
ADAM33	ABBREVIATION
SGK-1	ABBREVIATION
FFA1	ABBREVIATION
MCH-receptor	FULL_NAME
IKAP	ABBREVIATION
rno-miR-320	ABBREVIATION
OLD-35	ABBREVIATION
ACK1	ABBREVIATION
RORgammaT	ABBREVIATION
LXRa	ABBREVIATION
egfrs	ABBREVIATION
Aha	ABBREVIATION
Rev-erbα	ABBREVIATION
CRLF2	ABBREVIATION
EB (Epstein-Barr) virus miR-BART3	FULL_NAME
FRP	ABBREVIATION
Estrogen Receptor	FULL_NAME
cyclooxygenase-2	FULL_NAME
cyclooxygenase-1	FULL_NAME
NF- kappa B	ABBREVIATION
SPARC related modular calcium binding 1	FULL_NAME
mdm2	ABBREVIATION
LAPTM4B	ABBREVIATION
adenosine al receptor	FULL_NAME
FSH	ABBREVIATION
PI3K delta	FULL_NAME
cannabinoid CB2 receptor	FULL_NAME
DGAT1	ABBREVIATION
FPRL-1	ABBREVIATION
human FRS2β	FULL_NAME
neurokinin-1 (NK-1) receptor	NESTED
ß amyloid	FULL_NAME
LH-RH peptide	FULL_NAME
ceramide kinase	FULL_NAME
floR	ABBREVIATION
PTP-LAR	ABBREVIATION
Staphylococcus aureus div1b	FULL_NAME
GRS proteins	FULL_NAME
Estrogen receptor	FULL_NAME
IGF-2 P4	ABBREVIATION
FTR	ABBREVIATION
fprl-1	ABBREVIATION
VR-1	ABBREVIATION
protein kinase M zeta	FULL_NAME
CYP2C19	ABBREVIATION
Thrombopoietin	FULL_NAME
alpha7nAChR	ABBREVIATION
α1-GABAA receptor	FULL_NAME
PDE 1 0A	ABBREVIATION
PEDF-R	ABBREVIATION
tor	ABBREVIATION
TNF alpha	ABBREVIATION
epidermal growth factor receptor	FULL_NAME
SOD	ABBREVIATION
Akt	ABBREVIATION
Nef	ABBREVIATION
janus kinase 2	FULL_NAME
TBXAS1	ABBREVIATION
NS3-serine protease	FULL_NAME
Lhx4	ABBREVIATION
cannabinoid receptor CB1	FULL_NAME
cannabinoid receptor CB2	FULL_NAME
erbb	ABBREVIATION
LL-37	ABBREVIATION
human β3 adrenergic receptor	FULL_NAME
PTEN	ABBREVIATION
ezrin	FULL_NAME
Dipeptidase-IV	FULL_NAME
TXAS	ABBREVIATION
IP receptor	FULL_NAME
androgen receptor	FULL_NAME
Bruton's Tyrosine Kinase	FULL_NAME
mTOR	ABBREVIATION
MMP-13	ABBREVIATION
gonadotropin-releasing hormone receptor	FULL_NAME
cannabinoid cb2 receptors	FULL_NAME
E- selectin	FULL_NAME
17α-hydroxylase/C17,20-lyase	FULL_NAME
PepT1 transporter	FULL_NAME
catechol-O-methyltransferase	FULL_NAME
Type ii raf kinase	FULL_NAME
LFA-3	ABBREVIATION
erbB	ABBREVIATION
Somatostatin receptor	FULL_NAME
HIV-1 RT	FULL_NAME
erythropoietins	FULL_NAME
MMP-14	ABBREVIATION
prostate specific antigen	FULL_NAME
NRG1	ABBREVIATION
HTR3B	ABBREVIATION
CB1-receptor	FULL_NAME
hIGF	ABBREVIATION
TXA2	ABBREVIATION
Tumor Necrosis Factor - alpha	FULL_NAME
D2o receptor	FULL_NAME
flt3	ABBREVIATION
dopamine d3 receptor	FULL_NAME
glutaminyl cyclase	FULL_NAME
Ngp	ABBREVIATION
PI3-kinase α	ABBREVIATION
MC4 melanocortin receptors	FULL_NAME
Toll-like receptor-2	FULL_NAME
BPI	ABBREVIATION
GAPDH	ABBREVIATION
amyloid protein	FULL_NAME
cytochrome P40 2C8	FULL_NAME
Toll-like receptor-9	FULL_NAME
tumor necrosis factor (TNF)-alpha	NESTED
FXR	ABBREVIATION
luteinising hormone releasing hormone	FULL_NAME
folate-receptor	FULL_NAME
SRC	ABBREVIATION
SHIP2	ABBREVIATION
SHIP1	ABBREVIATION
hepatitis c virus serine protease	FULL_NAME
FXa	ABBREVIATION
alpha2A	ABBREVIATION
crh	ABBREVIATION
APRIL	ABBREVIATION
leukotriene C4 synthase	FULL_NAME
MFP-2	ABBREVIATION
glucocorticoid	FULL_NAME
follicle-stimulating hormone	FULL_NAME
PDE 10A	ABBREVIATION
C1r	ABBREVIATION
Smoothened (Smo) receptor	NESTED
adenosine A1 receptor	FULL_NAME
plk	ABBREVIATION
PPAR-gamma	ABBREVIATION
tumor necrosis factor Alpha	FULL_NAME
P-selectin	FULL_NAME
osteoclastogenesis inhibitory factor	FULL_NAME
topoisomerase I	FULL_NAME
α1-antitrypsin	FULL_NAME
HB-EGF	ABBREVIATION
BMP-6	ABBREVIATION
muscarinic M3 receptor	FULL_NAME
RIG-I	ABBREVIATION
Gb3 receptor	FULL_NAME
thrombopoietin receptor	FULL_NAME
KDR	ABBREVIATION
amylin	FULL_NAME
neuregulin 1	FULL_NAME
Tnfsf4	ABBREVIATION
creatine transporter	FULL_NAME
Human serum albumin	FULL_NAME
IL-1	ABBREVIATION
leukotriene A4 hydrolase	FULL_NAME
IL-4	ABBREVIATION
α4 integrin	ABBREVIATION
IL-5	ABBREVIATION
IL-2	ABBREVIATION
PTPsigma	ABBREVIATION
IL-3	ABBREVIATION
IL-8	ABBREVIATION
IL-6	ABBREVIATION
vegfr- 2	ABBREVIATION
cannabinoid receptor type 1	FULL_NAME
butyryl-cholinesterase	FULL_NAME
lumican	FULL_NAME
cannabinoid receptor type 2	FULL_NAME
fatty acid synthase	FULL_NAME
mglur5	ABBREVIATION
BTK	ABBREVIATION
B7-H3	ABBREVIATION
mglur4	ABBREVIATION
TRIM16	ABBREVIATION
gonadotropin releasing hormone receptor	FULL_NAME
SARS coronavirus 3CL prolease	FULL_NAME
human phosphatidylinositol 3-kinase delta	FULL_NAME
CETP	ABBREVIATION
igf-1r	ABBREVIATION
Αβ	ABBREVIATION
Heme oxygenase	FULL_NAME
5-Hydroxytryptamine-3 receptor	FULL_NAME
TGFB	ABBREVIATION
igf-1r tyrosine kinase	FULL_NAME
ccr5	ABBREVIATION
IL- 13	ABBREVIATION
ccr2	ABBREVIATION
ccr3	ABBREVIATION
sglt1	ABBREVIATION
sglt2	ABBREVIATION
plasminogen activator-1 (PAI-1) inhibitor	NESTED
human Geminin	ABBREVIATION
mutant EGFR	FULL_NAME
cannabinoid (CB) receptor	NESTED
APOB	ABBREVIATION
Wrap53	ABBREVIATION
rat SHARP	ABBREVIATION
IGF2	ABBREVIATION
DivlB	ABBREVIATION
KGF	ABBREVIATION
IGF1	ABBREVIATION
ccr1	ABBREVIATION
β2-AR	ABBREVIATION
Porcine CTLA-4	ABBREVIATION
aurora 2 kinase	FULL_NAME
RIP3	ABBREVIATION
Atr	ABBREVIATION
RIP1	ABBREVIATION
raf kinase	FULL_NAME
TFG&bgr	ABBREVIATION
ppy-miR-320a	ABBREVIATION
OPN	ABBREVIATION
SXR	ABBREVIATION
Caspase-3	FULL_NAME
P21	ABBREVIATION
BETA 3	ABBREVIATION
IGF-I receptor	ABBREVIATION
DPPIV	ABBREVIATION
catechol-o-methyltransferase	FULL_NAME
HMG-CoA reductase	FULL_NAME
VEGFR	ABBREVIATION
Hepatocyte Growth Factor	FULL_NAME
sirt2	ABBREVIATION
catalase	FULL_NAME
beta-catenin	FULL_NAME
IL10	ABBREVIATION
Gpr132	ABBREVIATION
receptor-interacting protein-3	FULL_NAME
hIGF-I	ABBREVIATION
α5	ABBREVIATION
SYK	ABBREVIATION
α7	ABBREVIATION
sphingosine 1 -phosphate (SlP) receptor	NESTED
receptor-interacting protein-1	FULL_NAME
IGF-1	ABBREVIATION
REIC	ABBREVIATION
biglycan	FULL_NAME
Dl receptor	ABBREVIATION
divalent metal transporter-1	FULL_NAME
tnf-alpha	ABBREVIATION
Bcl- 2	ABBREVIATION
nfkappab	ABBREVIATION
ssao	ABBREVIATION
CRTH2	ABBREVIATION
moesin	FULL_NAME
bleomycin hydrolase	FULL_NAME
kca3.1	ABBREVIATION
PD-1	ABBREVIATION
amyloid beta (Aβ) peptide	NESTED
GITR	ABBREVIATION
GBA	ABBREVIATION
HPV E6	FULL_NAME
Rankl mRNA	FULL_NAME
alpha2B receptors	FULL_NAME
Nol3	ABBREVIATION
corticotropin releasing hormone	FULL_NAME
Cannabinoid-2-receptor	FULL_NAME
LAG-3	ABBREVIATION
stat3	ABBREVIATION
CA125	ABBREVIATION
protein kinase D	FULL_NAME
Insulin receptor	FULL_NAME
transforming growth factor (“TGF”)-β	NESTED
l-cpt1	ABBREVIATION
hepatitis C (HCV) polymerase	FULL_NAME
CB2R	ABBREVIATION
somatostatin receptor	FULL_NAME
acetylcholinesterase	FULL_NAME
Myeloproliferative leukemia receptor	FULL_NAME
P53	ABBREVIATION
cycloocygenase-2	FULL_NAME
Glp-1	ABBREVIATION
Axl	ABBREVIATION
albumin	FULL_NAME
Fas	ABBREVIATION
IL-lß	ABBREVIATION
cyclooxygenase 2	FULL_NAME
Fibrinogen receptor	FULL_NAME
peroxisome proliferator­activated receptor gamma	FULL_NAME
Nf-:b	ABBREVIATION
CXCR-4	ABBREVIATION
NF-kappaB	ABBREVIATION
IGF1R	ABBREVIATION
Nociceptin	FULL_NAME
D-amino acid oxidase	FULL_NAME
keratocan	FULL_NAME
RAFT	ABBREVIATION
miR-185	ABBREVIATION
TNF-a	ABBREVIATION
vasopressin	FULL_NAME
PLA2	ABBREVIATION
cfa-miR-320	ABBREVIATION
ADAM10	ABBREVIATION
PPARη	ABBREVIATION
β-amyloid peptide	FULL_NAME
PPARα	ABBREVIATION
Lmo7	ABBREVIATION
rorgammat	ABBREVIATION
PPARγ	ABBREVIATION
tumor necrosis factorα	FULL_NAME
PPARδ	ABBREVIATION
ν-opioid	FULL_NAME
beta-2 adrenergic receptor	FULL_NAME
ADAM17	ABBREVIATION
microtubule affinity regulating kinase	FULL_NAME
SCNN1A	ABBREVIATION
Cathepsin c	FULL_NAME
hyaki	ABBREVIATION
epidermal growth factor	FULL_NAME
ConA	ABBREVIATION
RORγt	ABBREVIATION
α2C adrenergic receptor	FULL_NAME
protein tyrosine phosphatase 1B	FULL_NAME
IRS-1	ABBREVIATION
interleukin CXCR2	ABBREVIATION
Edg7 receptor	FULL_NAME
gcn2	ABBREVIATION
aurora-a	FULL_NAME
Sodium Glucose Co-Transporter 2	FULL_NAME
1190003K14Rik	ABBREVIATION
GRK6	ABBREVIATION
arginine vasopressin V1a receptor	FULL_NAME
Camkii	ABBREVIATION
muscarinic M4 receptors	FULL_NAME
P2Y12	ABBREVIATION
MGAT	ABBREVIATION
fatty-acid amide hydrolase	FULL_NAME
RAGE	ABBREVIATION
vascular endothelial growth factor 2	FULL_NAME
Nav1.7	ABBREVIATION
GRIN	ABBREVIATION
Fer	ABBREVIATION
dectin-1	FULL_NAME
Gpr119	ABBREVIATION
osteogenic growth peptide	FULL_NAME
cb1 receptors	FULL_NAME
microsomal prostaglandin E synthase- 1	FULL_NAME
IGPS	ABBREVIATION
DYRK2	ABBREVIATION
S1P1/Edg1	ABBREVIATION
ΙΚΚε	ABBREVIATION
2C subtype of brain serotonin receptors	FULL_NAME
GnRH receptor	FULL_NAME
pp-1	ABBREVIATION
NF-κB	ABBREVIATION
NMDA receptor NR1 subunit	FULL_NAME
Fibroblast Growth Factor Receptor (FGFR) 1	NESTED
BDNF allele	FULL_NAME
rab interaction molecule binding protein 3	FULL_NAME
D2 receptors	FULL_NAME
CA9	ABBREVIATION
glucocorticoid receptors	FULL_NAME
factor Xa	FULL_NAME
Iqgap2	ABBREVIATION
HDM2	ABBREVIATION
ucn	ABBREVIATION
cd300a	ABBREVIATION
amyloid-β	FULL_NAME
neurokinin  receptor 3	FULL_NAME
Edg-7 receptor	FULL_NAME
MDM2 Binding Protein	FULL_NAME
ß2adrenergic receptor	FULL_NAME
GIP	ABBREVIATION
CB2	ABBREVIATION
monoamine transporters	FULL_NAME
murine EHD4	FULL_NAME
CB1	ABBREVIATION
miR-155	ABBREVIATION
calcium sensing (Ca SR) receptors	NESTED
IL-1Beta	ABBREVIATION
YopP	ABBREVIATION
pgf2 alpha	ABBREVIATION
COX-2	ABBREVIATION
COX-1	ABBREVIATION
GSSG-r	ABBREVIATION
rab38	ABBREVIATION
p2x3	ABBREVIATION
HIF-1	ABBREVIATION
dipeptidyl- peptidase-IV	FULL_NAME
alanine transaminase	FULL_NAME
CRH-binding protein	FULL_NAME
collagen IV	FULL_NAME
galectin-2	FULL_NAME
galectin-3	FULL_NAME
phosphorylated p53	FULL_NAME
Bad	ABBREVIATION
farnesoid X receptor	FULL_NAME
ptr-miR-320a	ABBREVIATION
Bacteria topoisomerase ii	FULL_NAME
NF-.KAPPA.B	ABBREVIATION
CCK	ABBREVIATION
myeloperoxidase	FULL_NAME
KSR	ABBREVIATION
Human polynucleotide phosphorylase	FULL_NAME
CBl	ABBREVIATION
hiv-protease	FULL_NAME
CD4	ABBREVIATION
FKBP	ABBREVIATION
CRF2-12	ABBREVIATION
miR-138	ABBREVIATION
lrrk2	ABBREVIATION
FGF-7	ABBREVIATION
ERCC1	ABBREVIATION
CD8	ABBREVIATION
matriptase	FULL_NAME
Bax	ABBREVIATION
dopamine 3 (D3) receptor	FULL_NAME
KRAS	ABBREVIATION
androgen-receptor	FULL_NAME
glucocorticoid receptor	FULL_NAME
NK-1	ABBREVIATION
mGluRl	ABBREVIATION
GLK	ABBREVIATION
glucose transporter 4	FULL_NAME
microsomal prostaglandin E2 synthase-	FULL_NAME
h1-receptor	FULL_NAME
5-ht2	ABBREVIATION
5-ht3	ABBREVIATION
5-ht4	ABBREVIATION
MTBP	ABBREVIATION
5-ht5	ABBREVIATION
5-ht6	ABBREVIATION
Leukotriene-B-4 receptor	FULL_NAME
angiotensin converting enzyme	FULL_NAME
cytochrome P40-3A4	FULL_NAME
P2X3	ABBREVIATION
monoamine oxidase-B	FULL_NAME
P2X4	ABBREVIATION
human 5-lipoxygenase	FULL_NAME
metabotropic glutamate receptor subtype 5	FULL_NAME
angiotensin-converting enzyme	FULL_NAME
SREBP	ABBREVIATION
ErbB2	ABBREVIATION
5-ht2a serotonin receptor	ABBREVIATION
5Ht2	ABBREVIATION
Survivin	FULL_NAME
Bcr	ABBREVIATION
p2x7	ABBREVIATION
translocator protein	FULL_NAME
Ceramide kinase	FULL_NAME
angiotensin II	FULL_NAME
Linc	ABBREVIATION
hormone-sensitive lipase	FULL_NAME
glutaminase	FULL_NAME
EGF receptor	FULL_NAME
Mao-b	ABBREVIATION
encoding translation elongation factor Tu	FULL_NAME
histamine H2 receptor	FULL_NAME
kappa opioid receptors	FULL_NAME
DUX4-fl	ABBREVIATION
nociceptin	FULL_NAME
UCH-L1	ABBREVIATION
UCH-L3	ABBREVIATION
epiphycan	FULL_NAME
αvβ6 integrin receptor	FULL_NAME
beta-amyloid	FULL_NAME
HID-5	ABBREVIATION
RAPT	ABBREVIATION
interleukin-1β receptor	FULL_NAME
Epidermal Growth Factor Receptor	FULL_NAME
ICOS	ABBREVIATION
nuclear factor (NF)-kappa B	NESTED
Fatty-acid amide hydrolase	FULL_NAME
trkc	ABBREVIATION
PKMζ	ABBREVIATION
trka	ABBREVIATION
P2X7	ABBREVIATION
3-hydroxy-3-methylglutaryl- Coenzyme A reductase	FULL_NAME
murine double minute 2	FULL_NAME
Kappa opioid receptor	FULL_NAME
human amyloid β peptide	FULL_NAME
H19	ABBREVIATION
glytl	ABBREVIATION
FVIIa	ABBREVIATION
EHD4	ABBREVIATION
PAF	ABBREVIATION
TCN1	ABBREVIATION
folate receptor α	FULL_NAME
P2Y4	ABBREVIATION
GPR1 19	ABBREVIATION
cdc7	ABBREVIATION
m4 receptor	FULL_NAME
CDKN1B	ABBREVIATION
DMT1	ABBREVIATION
Mps l kinase	FULL_NAME
5-hydroxytryptamine-3 receptor	FULL_NAME
alpha7 nachr	ABBREVIATION
nociceptin receptor	FULL_NAME
dipeptidyl-peptidase iv	FULL_NAME
brd4	ABBREVIATION
sphingosine kinase 1	FULL_NAME
DEC1	ABBREVIATION
sphingosine kinase 2	FULL_NAME
GLP-1(7-37)	ABBREVIATION
lct4 synthase	ABBREVIATION
PBK	ABBREVIATION
prion	FULL_NAME
vitamin D receptor	FULL_NAME
L5R-alpha	ABBREVIATION
gpr6	ABBREVIATION
cb 1	ABBREVIATION
gpr8	ABBREVIATION
PBR	ABBREVIATION
HELLS	ABBREVIATION
CSBP	ABBREVIATION
GIP receptor	FULL_NAME
GIyT-1	ABBREVIATION
GIyT-2	ABBREVIATION
11βHSD1	ABBREVIATION
glyt1	ABBREVIATION
MKLP1	ABBREVIATION
Gpr39	ABBREVIATION
Pacap	ABBREVIATION
lymphoid-specific helicase	FULL_NAME
angiotensin	FULL_NAME
HbsAg	ABBREVIATION
VEGFR2	ABBREVIATION
GRN	ABBREVIATION
Mps-1	ABBREVIATION
has-miR-221*	ABBREVIATION
lysosyme	FULL_NAME
CK1	ABBREVIATION
PPAR alpha	ABBREVIATION
tenascin-c	FULL_NAME
STxB	ABBREVIATION
vasopressin 1b receptor	FULL_NAME
C1 esterase inhibitor	FULL_NAME
ror-gamma-t	FULL_NAME
BCL-2	ABBREVIATION
PDF	ABBREVIATION
Toll-like Receptor 2	FULL_NAME
peroxisome proliferator-activated receptor alpha	FULL_NAME
C1-INH	ABBREVIATION
beta-3 receptor	FULL_NAME
PI3Kd	ABBREVIATION
Monopolar Spindle 1 kinase	FULL_NAME
vanilloid VR-1	FULL_NAME
Pigr	ABBREVIATION
prolactin	FULL_NAME
L-1beta	ABBREVIATION
serotonin type 2A	FULL_NAME
hemopexin	FULL_NAME
tenascin-C	FULL_NAME
Wise	ABBREVIATION
human ICAM-1	FULL_NAME
Intestinal alpha-glucosidase	FULL_NAME
alpha 7 nachr	ABBREVIATION
epidermal growth factor receptors	FULL_NAME
factor viia	FULL_NAME
SMOC1	ABBREVIATION
K-Opoid Receptor	FULL_NAME
Integrin ALPHAVBETA3	FULL_NAME
human KCNQ	FULL_NAME
NK-3 receptors	FULL_NAME
c-met	ABBREVIATION
antagonising angiotensin II Type 2 (AT2) receptor	NESTED
tumour necrosis factor(alpha)	FULL_NAME
RANKL	ABBREVIATION
gpr40	ABBREVIATION
LPA receptor LPAR5	FULL_NAME
NF-kB	ABBREVIATION
FloR	ABBREVIATION
Phosphodiesterase 1 0A	FULL_NAME
TNF	ABBREVIATION
beta-3 adrenoreceptor	FULL_NAME
G-protein coupled receptor 88	FULL_NAME
EMMPRIN	ABBREVIATION
substance P	FULL_NAME
11β-HSD1	ABBREVIATION
human SCCE	ABBREVIATION
dopamine d2	FULL_NAME
11-beta-HSD1	ABBREVIATION
CyPA	ABBREVIATION
DYRK1A	ABBREVIATION
DYRK1B	ABBREVIATION
heparin-binding EGF-like growth factor-like growth factor	FULL_NAME
d2 receptors	FULL_NAME
RAB38	ABBREVIATION
TCPTP	ABBREVIATION
ricin	FULL_NAME
Human Serum Albumin	FULL_NAME
skip	ABBREVIATION
HIV protease	FULL_NAME
PinI	ABBREVIATION
ileal bile acid transport	FULL_NAME
mag	ABBREVIATION
beta amyloid	FULL_NAME
A2B adenosine receptor	FULL_NAME
dipeptidyl peptidase iv	FULL_NAME
Fatty acid synthase	FULL_NAME
RAB6A	ABBREVIATION
PLTP	ABBREVIATION
protein DJ-1	FULL_NAME
type-i 11β-hydroxysteroid dehydrogenase	FULL_NAME
cdk9	ABBREVIATION
S1P5 Receptor	FULL_NAME
fatty acid amido hydrolase	FULL_NAME
cdk1	ABBREVIATION
H4 receptor	FULL_NAME
serum albumin	FULL_NAME
NF (nuclear factor)-kappa B	NESTED
tyrosinase	FULL_NAME
dopamine D3 receptor	FULL_NAME
Par-1	ABBREVIATION
chemokine receptor CCR-2	FULL_NAME
MGLUR2	ABBREVIATION
hepatic cell growth factor receptor	FULL_NAME
Tusc2	ABBREVIATION
Mdm2	ABBREVIATION
LHX4	ABBREVIATION
LAR	ABBREVIATION
erbB1	ABBREVIATION
erbB2	ABBREVIATION
glucose dependent insulinotropic receptor	FULL_NAME
Rho kinase	FULL_NAME
Flt4	ABBREVIATION
BCMA	ABBREVIATION
EDG2	ABBREVIATION
ErbB	ABBREVIATION
adrenocorticotropic hormone	FULL_NAME
CYR61	ABBREVIATION
mch	ABBREVIATION
dipeptidyl peptidase-iv	FULL_NAME
HIV-1 Tat	FULL_NAME
Hdgfrp3	ABBREVIATION
TRX	ABBREVIATION
transketolase like-1	FULL_NAME
OSTbeta	ABBREVIATION
Cav3.2	ABBREVIATION
β-amyloid	FULL_NAME
PDE5	ABBREVIATION
PDE7	ABBREVIATION
CR4	ABBREVIATION
tyrosine kinase containing Ig and EGF homology domains	FULL_NAME
TRPC3	ABBREVIATION
TRPC4	ABBREVIATION
PKB	ABBREVIATION
PDE4	ABBREVIATION
TNF-Alpha	ABBREVIATION
protein-tyrosine-phosphatase 1B	FULL_NAME
PKG	ABBREVIATION
Epha2	ABBREVIATION
Epha4	ABBREVIATION
n-methyl-d-aspartate receptor nr1 subunit	FULL_NAME
connective tissue growth factor	FULL_NAME
Pinl	ABBREVIATION
Sterol Regulatory Element-Binding Protein 1	FULL_NAME
Ski-interacting protein	FULL_NAME
LCK	ABBREVIATION
CRF	ABBREVIATION
prostaglandin e synthase	FULL_NAME
PKR	ABBREVIATION
CRH	ABBREVIATION
vasoactive intestinal polypeptide	FULL_NAME
cytosolic PLA2	FULL_NAME
CATSPER1	ABBREVIATION
CRP	ABBREVIATION
Ku70	ABBREVIATION
HDAC2	ABBREVIATION
influenza A RNA-dependent RNA polymerase	FULL_NAME
CRT	ABBREVIATION
Src	ABBREVIATION
HDAC1	ABBREVIATION
rab27b	ABBREVIATION
NT-3	ABBREVIATION
TTK	ABBREVIATION
15-lipoxygenase	FULL_NAME
phosphorylated Smad1	FULL_NAME
HDAC8	ABBREVIATION
CYP3A4	ABBREVIATION
PLK	ABBREVIATION
inducible nitric oxide synthase	FULL_NAME
HER 2	ABBREVIATION
β-catenin	FULL_NAME
TTR	ABBREVIATION
P2RY5	ABBREVIATION
serotonin 5-ht6 receptors	FULL_NAME
growth hormone	FULL_NAME
human CD4	FULL_NAME
TRPA1	ABBREVIATION
urocortin	FULL_NAME
Tie2	ABBREVIATION
Tie1	ABBREVIATION
Beta-ENaC	FULL_NAME
MrgX1	ABBREVIATION
signal transducer and activator of transcription 3	FULL_NAME
receptor for activation of nuclear factor kappa B ligand	FULL_NAME
IDH2m	ABBREVIATION
prenyltransferase Fnq26	FULL_NAME
MrgX2	ABBREVIATION
1 type cysteinyl leukotriene receptor	FULL_NAME
p110 delta	ABBREVIATION
VEGFR-3	ABBREVIATION
VEGFR-2	ABBREVIATION
VEGFR-1	ABBREVIATION
TGFβ	ABBREVIATION
11β-hydroxy-steroid dehydrogenase type 1	FULL_NAME
cg15862	ABBREVIATION
Cav2.2 CALCIUM CHANNELS	FULL_NAME
aP2	ABBREVIATION
receptor protein tyrosine kinase Axl	FULL_NAME
hiv reverse transcriptase	FULL_NAME
5-ht2a	ABBREVIATION
AQP4	ABBREVIATION
AQP3	ABBREVIATION
pre-haptoglobin 2	FULL_NAME
5-ht2b	ABBREVIATION
tumor necrosis factor-alpha	FULL_NAME
s1p	ABBREVIATION
aPC	ABBREVIATION
s100a4	ABBREVIATION
lactoferrin	FULL_NAME
PDK1	ABBREVIATION
BCRP	ABBREVIATION
TKTL1	ABBREVIATION
ribonucleotide reductase subunit 2	FULL_NAME
Toll-like receptor 2	FULL_NAME
Raf kinases	FULL_NAME
cg11447	ABBREVIATION
human immunodeficiency virus (HIV)-1 reverse transcriptase	FULL_NAME
HLA-A	ABBREVIATION
Ku86	ABBREVIATION
hepatocyte growth factor receptor	FULL_NAME
PP1	ABBREVIATION
tumour necrosis factor-α	FULL_NAME
plasminogen activator inhibitor-1	FULL_NAME
CB1 receptor	FULL_NAME
human VR1 receptor	FULL_NAME
ip3r	ABBREVIATION
nociceptive receptors	FULL_NAME
Btk	ABBREVIATION
SIK3	ABBREVIATION
SIK1	ABBREVIATION
SIK2	ABBREVIATION
5-hydroxytryptamine receptor 7	FULL_NAME
CFTR	ABBREVIATION
programmed cell death protein 2	FULL_NAME
insulin	FULL_NAME
miR-146a	ABBREVIATION
transglutaminase 2	FULL_NAME
Glut4	ABBREVIATION
Adiponectin	FULL_NAME
histamine H4 receptor	FULL_NAME
HIV reverse transcriptase	FULL_NAME
TRPM8	ABBREVIATION
mao-b	ABBREVIATION
heat shock protein 90	FULL_NAME
GADD34	ABBREVIATION
μ opioid receptors	FULL_NAME
pyruvate kinase M2	FULL_NAME
pai-1	ABBREVIATION
proinsulin	FULL_NAME
HAL	ABBREVIATION
URAT1	ABBREVIATION
PDKI	ABBREVIATION
M1 Receptor	FULL_NAME
blood clotting enzymes factor Xa	FULL_NAME
mml-miR-320	ABBREVIATION
human IGF-II	FULL_NAME
HOTAIR	ABBREVIATION
Pim-1	ABBREVIATION
erp57	ABBREVIATION
Transferrin	FULL_NAME
CB2 cannabinoid receptors	FULL_NAME
Ctsg	ABBREVIATION
Flightless I	FULL_NAME
water channel	FULL_NAME
tlr-2	ABBREVIATION
MadC AM- 1	ABBREVIATION
malate dehydrogenase	FULL_NAME
15-LOX	ABBREVIATION
LXR alpha	ABBREVIATION
phosphoinositide 3-kinase gamma	FULL_NAME
Ccr8	ABBREVIATION
Plexin-B1	FULL_NAME
CSF-1R	ABBREVIATION
PSA	ABBREVIATION
insulin-like growth factor-1 receptor	FULL_NAME
Syk	ABBREVIATION
miR-886-3p	ABBREVIATION
coagulation factor VIIa	FULL_NAME
TYK2	ABBREVIATION
Gag	ABBREVIATION
IL-1β	ABBREVIATION
pd-1	ABBREVIATION
ORL1	ABBREVIATION
bradykinin b1	FULL_NAME
A beta	ABBREVIATION
delta receptor	FULL_NAME
Edg 7 receptor	FULL_NAME
TLR9	ABBREVIATION
TLR8	ABBREVIATION
dopamine D3 receptors	FULL_NAME
TLR7	ABBREVIATION
syk tryrosine kinase	FULL_NAME
TLR4	ABBREVIATION
CPT-1	ABBREVIATION
TLR3	ABBREVIATION
TLR2	ABBREVIATION
IPstpip2	ABBREVIATION
dopamine D4	FULL_NAME
cannabinoid cb1 receptor	FULL_NAME
Tie-2	ABBREVIATION
Water channel	FULL_NAME
folate receptor alpha	FULL_NAME
NOL3	ABBREVIATION
CYP7A1	ABBREVIATION
PDGFRβ	ABBREVIATION
camkiv	ABBREVIATION
PDGFRα	ABBREVIATION
RNase-L	ABBREVIATION
amyloid precursor protein	FULL_NAME
CCR-3	ABBREVIATION
Survival Motor Neuron (SMN) protein	NESTED
B7-h3	ABBREVIATION
CCR-1	ABBREVIATION
PILRα	ABBREVIATION
c-met tyrosine kinase	FULL_NAME
Runx2	ABBREVIATION
folate receptor type α	FULL_NAME
ILT3	ABBREVIATION
GLP-1	ABBREVIATION
vascular endothelial growth factor receptor 2	FULL_NAME
HUMAN β3 ADRENERGIC RECEPTOR	FULL_NAME
ctla4	ABBREVIATION
c-reactive protein	FULL_NAME
neurokinin 1	FULL_NAME
sglt	ABBREVIATION
aspartate aminotransferase	FULL_NAME
mmu-miR-320	ABBREVIATION
OspA	ABBREVIATION
edg-3	ABBREVIATION
OspC	ABBREVIATION
gpr119	ABBREVIATION
edg-1	ABBREVIATION
activated Cdc42-associated kinase	FULL_NAME
GRS protein	FULL_NAME
SHIP 1	ABBREVIATION
gdir	ABBREVIATION
Matriptase	FULL_NAME
rat apoptosis-specific eucaryotic initiation Factor-5A	FULL_NAME
laminin V	FULL_NAME
interferon-y	FULL_NAME
mark	ABBREVIATION
dopamine D2	FULL_NAME
AMPA	ABBREVIATION
TNF-alpha	ABBREVIATION/FULL_NAME
Cxcr2	ABBREVIATION
human icam-1	FULL_NAME
Hiv protease	FULL_NAME
NK3 receptor	FULL_NAME
human GLP-1 receptor	FULL_NAME
CUL4A ubiquitin ligase	FULL_NAME
HGF	ABBREVIATION
transthyretin	FULL_NAME
histone deacetylase 8	FULL_NAME
Transthyretin	FULL_NAME
PI3Kβ	ABBREVIATION
mpl	ABBREVIATION
orexin (OX) receptor	NESTED
PI3Kδ	ABBREVIATION
miR27b	ABBREVIATION
PI3Kγ	ABBREVIATION
mpo	ABBREVIATION
histone deacetylase 1	FULL_NAME
non-structural protein 5A	FULL_NAME
dpp-iv	ABBREVIATION
N-formyl peptide receptor like-1	FULL_NAME
Sirt2	ABBREVIATION
semicarbazide-sensitive amine oxidase	FULL_NAME
HEL-215	ABBREVIATION
LPA	ABBREVIATION
bta-miR-320	ABBREVIATION
5830484A20Rik	ABBREVIATION
cholesteryl ester transfer protein	FULL_NAME
hiv integrase	FULL_NAME
mtor kinase	FULL_NAME
PXR	ABBREVIATION
HER-2	ABBREVIATION
HER-1	ABBREVIATION
interleukin-1β	FULL_NAME
M1R	ABBREVIATION
Ptch1	ABBREVIATION
neutrophilic collagenase	FULL_NAME
Shiga Toxin B subunit	ABBREVIATION
PD-L1	ABBREVIATION
L-selectin	FULL_NAME
PD-L2	ABBREVIATION
λ2 opioid	FULL_NAME
vanilloid receptor 1	FULL_NAME
VAP-I	ABBREVIATION
Zbtb20	ABBREVIATION
angiotensin receptor type- 1	FULL_NAME
interferon-gamma	FULL_NAME
microsomal transfer protein	FULL_NAME
NaV1.8	ABBREVIATION
RSK1	ABBREVIATION
Raf kinase	FULL_NAME
TRPV3	ABBREVIATION
Raf-1	ABBREVIATION
TRPV1	ABBREVIATION
RSK2	ABBREVIATION
HIP	ABBREVIATION
(TIE) -2	ABBREVIATION
Smad1	ABBREVIATION
Smad3	ABBREVIATION
Ppar-gamma	ABBREVIATION
C-Met tyrosine kinase	FULL_NAME
TRPV4	ABBREVIATION
acetyl CoA (acetyl coenzyme A):diacylglycerol acyltransferase	FULL_NAME
Cyclooxygenase-2	FULL_NAME
FGFR4	ABBREVIATION
FGFR3	ABBREVIATION
FGFR2	ABBREVIATION
FGFR1	ABBREVIATION
UCN	ABBREVIATION
Tat	FULL_NAME
Tau	FULL_NAME
HCV protease	FULL_NAME
monoamine oxidase B	FULL_NAME
monoamine oxidase A	FULL_NAME
kappa-2 opioid	FULL_NAME
IFN-α	ABBREVIATION
interleukin 6	FULL_NAME
IFN-γ	ABBREVIATION
CHEMOKINE RECEPTOR CxCR3	FULL_NAME
interleukin 1	FULL_NAME
endothelial nitric oxide synthase	FULL_NAME
deleted variant HGF	FULL_NAME
5-HT2A serotonin receptor	ABBREVIATION
Bruton's tyrosine kinase	FULL_NAME
Shiga toxin B	FULL_NAME
hsa-miR-320a	ABBREVIATION
1 L6	ABBREVIATION
S 100A6	ABBREVIATION
axin	FULL_NAME
integrin αvβ6	FULL_NAME
VAP-1	ABBREVIATION
secretin	FULL_NAME
factor xa	FULL_NAME
S 100A4	ABBREVIATION
dpp-4	ABBREVIATION
Regulated Upon Activation, Normal T-cell Expressed and Secreted	FULL_NAME
c-Kit	ABBREVIATION
aggrecanase	FULL_NAME
death programmed protein 2	FULL_NAME
CSF 1R	ABBREVIATION
Shiga toxin b	FULL_NAME
MDA5	ABBREVIATION
Nuclear factor kappa b	FULL_NAME
5-ht17	ABBREVIATION
Igfbp2	ABBREVIATION
MUC1	ABBREVIATION
k-receptor	FULL_NAME
thromboxane synthase	FULL_NAME
HES1	ABBREVIATION
HES5	ABBREVIATION
SNCA	ABBREVIATION
eIF4E	ABBREVIATION
5-ht1a	ABBREVIATION
Cox-2	ABBREVIATION
mGluR2	ABBREVIATION
mGluR1	ABBREVIATION
Tek	ABBREVIATION
HER2	ABBREVIATION
mGluR5	ABBREVIATION
HER1	ABBREVIATION
eIF4A	ABBREVIATION
mGluR4	ABBREVIATION
HER4	ABBREVIATION
HNE	ABBREVIATION
glucokinase	FULL_NAME
CA IX	ABBREVIATION
pde-5	ABBREVIATION
interleukin-2	FULL_NAME
eNOS	ABBREVIATION
gapdh	ABBREVIATION
corticotropin-releasing hormone (CRH) receptor-1 (R1)	NESTED
5-HT2	ABBREVIATION
interleukin-6	FULL_NAME
5-HT3	ABBREVIATION
A1	ABBREVIATION
5-HT4	ABBREVIATION
5-HT5	ABBREVIATION
5-HT6	ABBREVIATION
5-HT7	ABBREVIATION
interleukin-27	FULL_NAME
CYP2D6	ABBREVIATION
CK1γ	ABBREVIATION
raf	ABBREVIATION
orl-1	ABBREVIATION
TALL-1	ABBREVIATION
HIV-1 and HIV-2 reverse transcriptase	FULL_NAME
ErbB-2	ABBREVIATION
L-CPT1	ABBREVIATION
acetyl cholinesterase	FULL_NAME
mip-1-alpha	FULL_NAME
reverse transcriptase	FULL_NAME
hsp27	ABBREVIATION
mammalian Target of Rapamycin	FULL_NAME
bradykinin	FULL_NAME
EML4	ABBREVIATION
human transferrin	FULL_NAME
AR	ABBREVIATION
RBP4	ABBREVIATION
HbeAg	ABBREVIATION
B7	ABBREVIATION
IFNα-7	ABBREVIATION
pa-il lectin	FULL_NAME
HMG-COA reductase	FULL_NAME
old-35	ABBREVIATION
miR-30a	ABBREVIATION
Serum Amyloid A	FULL_NAME
Chk2	ABBREVIATION
BP	ABBREVIATION
NCAPH	ABBREVIATION
DHS	ABBREVIATION
CYP2B6	ABBREVIATION
ECSM2	ABBREVIATION
TGF-β	ABBREVIATION
COX1	ABBREVIATION
ptp1b	ABBREVIATION
CB	ABBREVIATION
Histone deacetylase 8	FULL_NAME
SGLT2	ABBREVIATION
Fzd6	ABBREVIATION
cg18418	ABBREVIATION
G-Protein-Coupled Receptor Gpr39	FULL_NAME
MAO-B	ABBREVIATION
Fgfr3	ABBREVIATION
Na+/glucose transporter	FULL_NAME
alpha 1d adrenergic receptors	FULL_NAME
D4	ABBREVIATION
TrkC	ABBREVIATION
CYP2C9	ABBREVIATION
VCAM-1	ABBREVIATION
TrkA	ABBREVIATION
NF-?B	ABBREVIATION
MAO-A	ABBREVIATION
RNA-like endoplasmic reticulum kinase	FULL_NAME
Argonaute2	FULL_NAME
HIV Tat protein	FULL_NAME
NOX3	ABBREVIATION
DELTA <5> desaturase	FULL_NAME
Tyrosinase	FULL_NAME
human insulin-like growth factor	FULL_NAME
SIRTI	ABBREVIATION
cholinesterase	FULL_NAME
tspo	ABBREVIATION
pde10	ABBREVIATION
pregnane X receptor	FULL_NAME
Gli1	ABBREVIATION
cholinesterases	FULL_NAME
thymidylate synthase mRNA	FULL_NAME
HSA	ABBREVIATION
HEY2	ABBREVIATION
CTLA4	ABBREVIATION
PAI-1	ABBREVIATION
human leukocyte antigen DR4 subtype protein	FULL_NAME
type-3 17β-hydroxysteroid dehydrogenase	FULL_NAME
IA-2	ABBREVIATION
keratinocyte growth factor	FULL_NAME
GPR39	ABBREVIATION
IGF1 R	ABBREVIATION
itk	ABBREVIATION
B Raf	ABBREVIATION
G protein-coupled receptor 88	FULL_NAME
dipeptidase-IV	FULL_NAME
VEGF-D	ABBREVIATION
SIRT1	ABBREVIATION
ER	ABBREVIATION
jak3	ABBREVIATION
neuropeptide y y5 receptor	FULL_NAME
florfenicol drug resistance gene protein	FULL_NAME
pgd2	ABBREVIATION
Fragile X mental retardation 1 neighbor protein	FULL_NAME
focal adhesion kinase	FULL_NAME
nuclear transcription factor ap-1	FULL_NAME
NY-SAR-35	ABBREVIATION
Rab27B	ABBREVIATION
Bcl-2	ABBREVIATION
egfr	ABBREVIATION
Interleukin-2	FULL_NAME
tumor necrosis factor α	FULL_NAME
CypA	ABBREVIATION
human neutrophil elastase	FULL_NAME
Janus tyrosine kinase 3	FULL_NAME
HO-1	ABBREVIATION
Interleukin-9	FULL_NAME
SIK kinase	ABBREVIATION
NFkB	ABBREVIATION
GPR40	ABBREVIATION
fatty acid amide hydrolase	FULL_NAME
syk-kinase	FULL_NAME
UCP3	ABBREVIATION
UCP2	ABBREVIATION
STAT5	ABBREVIATION
PMS2	ABBREVIATION
STAT6	ABBREVIATION
Cholesterol ester transfer protein	FULL_NAME
glyceraldehyde-3-phosphate dehydrogenase	FULL_NAME
Gag polyprotein	FULL_NAME
LRHA	ABBREVIATION
SIRTl	ABBREVIATION
α7 nicotinic acetylcholine subtype	FULL_NAME
GST-4α	ABBREVIATION
filamin a	FULL_NAME
GST-4β	ABBREVIATION
STAT3	ABBREVIATION
H1	ABBREVIATION
topoisomerase Ilα	FULL_NAME
GR	ABBREVIATION
Crlf2	ABBREVIATION
neurokinin (NK) receptor	NESTED
pgds	ABBREVIATION
NALP1	ABBREVIATION
vr1	ABBREVIATION
NALP3	ABBREVIATION
Alpha7 nicotinic acetylcholine receptor	FULL_NAME
mpges-1	ABBREVIATION
Raf protein kinase	FULL_NAME
S1P lyase	FULL_NAME
hPPAR gamma	FULL_NAME
condensing complex subunit 2	FULL_NAME
Shiga toxin	FULL_NAME
phospholipase A1	FULL_NAME
α4β7	ABBREVIATION
crystallin beta B2	FULL_NAME
FerT.	ABBREVIATION
Mitf	ABBREVIATION
FP receptor	FULL_NAME
α4β1	ABBREVIATION
Tnf	ABBREVIATION
α4β2	ABBREVIATION
CTGF	ABBREVIATION
PEDF	ABBREVIATION
crf1	ABBREVIATION
beta 2-adrenoreceptors	FULL_NAME
PIM1	ABBREVIATION
flk-1	ABBREVIATION
gp130	ABBREVIATION
15-hydroxyprostaglandin dehydrogenase	FULL_NAME
DPP IV	ABBREVIATION
xanthine oxidase	FULL_NAME
5HT1a	ABBREVIATION
Cg8327	ABBREVIATION
5HT2C	ABBREVIATION
rnase-l	ABBREVIATION
histamine H3 receptor	FULL_NAME
thrombopoietin	FULL_NAME
tgfbeta	ABBREVIATION
β2-ΑR	ABBREVIATION
TRP M8	ABBREVIATION
ahr	ABBREVIATION
sodium-calcium exchanger of subtype 1	FULL_NAME
glucosylceramide synthase	FULL_NAME
FOXP3	ABBREVIATION
gonadotropin-releasing hormone	FULL_NAME
psoriasin	FULL_NAME
S100A6	ABBREVIATION
vascular endothelial growth factor receptor tyrosine kinase	FULL_NAME
17beta-hydroxysteroid dehydrogenase type 2	FULL_NAME
kidney-type glutaminase	FULL_NAME
Nuclear factor .kappa.b	FULL_NAME
PI3K (delta)	FULL_NAME
ApoE4	ABBREVIATION
sst5C	ABBREVIATION
Adrenomedullin	FULL_NAME
sst5B	ABBREVIATION
epithelial growth factor receptor tyrosine protein kinase	FULL_NAME
NPY Y5	ABBREVIATION
Sodium dependent glucose transporter 1	FULL_NAME
KCa3.1	ABBREVIATION
b-raf	ABBREVIATION
dipeptidyl peptidase IV	FULL_NAME
Pyruvate kinase M2	FULL_NAME
HMG-CoA REDUCTASE	FULL_NAME
lactoperoxidase	FULL_NAME
Cav2.2	ABBREVIATION
MC4	ABBREVIATION
human CD40	FULL_NAME
mPGES-1	ABBREVIATION
nrf2	ABBREVIATION
PAR-1	ABBREVIATION
BDNF	ABBREVIATION
Kappa	ABBREVIATION
hiv protease	FULL_NAME
angiotensin I	FULL_NAME
Lh-rh peptide	FULL_NAME
Glutathione Reductase	FULL_NAME
peripheralbenzodiazepine receptor	FULL_NAME
GlyT1	ABBREVIATION
Pstpip2	ABBREVIATION
GPR92	ABBREVIATION
has-miR-29c	ABBREVIATION
D3 receptor	ABBREVIATION
alpha2c adrenergic receptor	FULL_NAME
MDM2	ABBREVIATION
DP 4	ABBREVIATION
thrombine	FULL_NAME
capsaicin receptor	FULL_NAME
transcobalamin i	FULL_NAME
FLT3	ABBREVIATION
KSRP	ABBREVIATION
LRRK2	ABBREVIATION
retinoic-acid-inducible gene I	FULL_NAME
CB2 receptors	FULL_NAME
C-kit	ABBREVIATION
akt	ABBREVIATION
endothelial lipase	FULL_NAME
SOD-I	ABBREVIATION
mammalian thymidylate synthase mRNA	FULL_NAME
Trp	ABBREVIATION
dipeptidyl peptidase-IV	FULL_NAME
Ship1	ABBREVIATION
nep	ABBREVIATION
iNOS	ABBREVIATION
PTP-1B	ABBREVIATION
RecA recombinase	FULL_NAME
prostaglandin D2 receptor	FULL_NAME
IpaD protein	FULL_NAME
neu	ABBREVIATION
rv3790	ABBREVIATION
alk	ABBREVIATION
GP73	ABBREVIATION
Substance P	FULL_NAME
Pkb	ABBREVIATION
SARS coronavirus 3CL protease	FULL_NAME
interleukin (IL)-1	FULL_NAME
IL-1Alpha	ABBREVIATION
NK-3 receptor	FULL_NAME
PIK3CA	ABBREVIATION
Lck	ABBREVIATION
Lcn	ABBREVIATION
hepatitis C NS5B polymerase	FULL_NAME
serum and glucocorticoid regulated kinase isoform 1	FULL_NAME
Mcl-l	ABBREVIATION
Cyr61	ABBREVIATION
PLUNC	ABBREVIATION
c-erbB2	ABBREVIATION
EphA2	ABBREVIATION
Plk	ABBREVIATION
EphA4	ABBREVIATION
MDR1	ABBREVIATION
telomerase	FULL_NAME
Poly (ADP-ribose) polymerase 1	FULL_NAME
miR-151-3p	ABBREVIATION
tumor necrosis factor (TNF)-α	NESTED
acetylcholin esterase	FULL_NAME
nt-3	ABBREVIATION
Rad51	ABBREVIATION
SLC12A2	ABBREVIATION
MMAA	ABBREVIATION
EB virus miR-BART3	FULL_NAME
MMAB	ABBREVIATION
vascular adhesion protein-1	FULL_NAME
IL-18 binding protein	FULL_NAME
EphB4	ABBREVIATION
Ass1	ABBREVIATION
steroid sulfatase	FULL_NAME
Mcl-1	ABBREVIATION
cannabinnoid-2-receptor	FULL_NAME
Bcl-xL	ABBREVIATION
Cancer/testis antigen 37	FULL_NAME
5-ht-5a	ABBREVIATION
HCV polymerase	FULL_NAME
Cd8b1	ABBREVIATION
11β-hydroxylated steroid dehydrogenase type 1	FULL_NAME
Sost	ABBREVIATION
11-beta-hydroxysteroid dehydrogenase type I	FULL_NAME
peroxisome proliferator-activated receptor γ	FULL_NAME
polo like kinase	FULL_NAME
PR	ABBREVIATION
11beta-HSD1	ABBREVIATION
plasmepsin II	FULL_NAME
serine-threonine kinase protein kinase B	FULL_NAME
human SGLT1	FULL_NAME
human SGLT2	FULL_NAME
HIF-1α	ABBREVIATION
translation elongation factor G	FULL_NAME
topoisomerase ii	FULL_NAME
Hsp70	ABBREVIATION
dopamine D2 receptor	FULL_NAME
apc	ABBREVIATION
dopa decarboxylase	FULL_NAME
caspase-1	FULL_NAME
presenilin-2	FULL_NAME
5-HT3A	ABBREVIATION
caspase-3	FULL_NAME
Histamine H3	FULL_NAME
serotonin 5-HT6 receptor	FULL_NAME
R2	ABBREVIATION
EPHA4	ABBREVIATION
EPHA7	ABBREVIATION
α2C adrenergic receptors	FULL_NAME
macrophage migration inhibitory factor	FULL_NAME
alpha 1a	ABBREVIATION
lysophosphatidic acid (lpa) receptor	NESTED
ERO1-Lα	ABBREVIATION
type I IFN receptor IFNAR1	FULL_NAME
MIF	ABBREVIATION
GluR2	ABBREVIATION
TM4SF4	ABBREVIATION
Pol	ABBREVIATION
EP4 receptor	FULL_NAME
11β-HYDROXYSTEROID DEHYDROGENASE TYPE 1	FULL_NAME
GSK3 beta	ABBREVIATION
MIP-1-alpha	FULL_NAME
RT	ABBREVIATION
Beta Amyloid	FULL_NAME
11beta-hydroxyoxysterooid dehydrogenase type I	FULL_NAME
PPAR gamma	ABBREVIATION
Hsp90	ABBREVIATION
A2A	ABBREVIATION
Type 3 17β-Hydroxysteroid Dehydrogenase	FULL_NAME
Rb	ABBREVIATION
A2B	ABBREVIATION
enolase 2	ABBREVIATION
SF	ABBREVIATION
LXR beta	ABBREVIATION
tgfb	ABBREVIATION
PKB kinase	FULL_NAME
CD14	ABBREVIATION
5-HT5A	ABBREVIATION
CCR1	ABBREVIATION
Mrp1	ABBREVIATION
FabI	ABBREVIATION
neuropeptide Y Y5	FULL_NAME
receptor for advanced glycation endproducts	FULL_NAME
5HT-3	ABBREVIATION
Gelatinase	FULL_NAME
transforming growth factor-beta 1	FULL_NAME
cetp	ABBREVIATION
FK-506 binding protein	FULL_NAME
chemokine receptor CxCR3	FULL_NAME
TF	ABBREVIATION
SlPl	ABBREVIATION
HIV gp120 protein	FULL_NAME
CD28	ABBREVIATION
Flt-3	ABBREVIATION
TS	ABBREVIATION
sodium/glucose cotransporter 2	FULL_NAME
CD40	ABBREVIATION
Ed-4	ABBREVIATION
pentraxin PTX3	FULL_NAME
PCSK9	ABBREVIATION
IKBKAP	ABBREVIATION
BRCA1	ABBREVIATION
MLN	ABBREVIATION
mcp-1	ABBREVIATION
PIM-2	ABBREVIATION
PIM-1	ABBREVIATION
PIM-3	ABBREVIATION
ERK1	ABBREVIATION
IDO	ABBREVIATION
CCR9	ABBREVIATION
CD38	ABBREVIATION
Cmet	ABBREVIATION
CCR5	ABBREVIATION
CD34	ABBREVIATION
5-LOX	ABBREVIATION
CCR3	ABBREVIATION
atr	ABBREVIATION
CCR2	ABBREVIATION
heme oxygenase	FULL_NAME
human peroxisome proliferator activated receptor gamma	FULL_NAME
decorin	FULL_NAME
CCRl	ABBREVIATION
SSAO	ABBREVIATION
functional cystic fibrosis transmembrane conductance regulator	FULL_NAME
inositol 1,4,5-trisphosphate 3-kinase B	FULL_NAME
ER-α	ABBREVIATION
ER-β	ABBREVIATION
m1 receptor	FULL_NAME
Alpha IIB	ABBREVIATION
Dkk-3	ABBREVIATION
TECK	ABBREVIATION
CD43	ABBREVIATION
Kidney-type glutaminase	FULL_NAME
xanthine oxidoreductase	FULL_NAME
DPP-IV	ABBREVIATION
human rHuPSP94	FULL_NAME
CTLA-8	ABBREVIATION
Dipeptidyl peptidase IV	FULL_NAME
PERK	ABBREVIATION
alpha7-acetylcholine receptor	FULL_NAME
Plexin-131	FULL_NAME
CYP2A13	ABBREVIATION
TIE-2	ABBREVIATION
Human epididymal expression sperm binding protein HEL-215	FULL_NAME
TIE-1	ABBREVIATION
11beta-hydroxysteriod dehydrogenase 1	FULL_NAME
lincRNA	ABBREVIATION
CTLA-4	ABBREVIATION
11 β-hydroxysteroid dehydrogenase type 1	FULL_NAME
NS3 protease	FULL_NAME
β3 adrenergic receptors	FULL_NAME
mecp2	ABBREVIATION
Ostα	ABBREVIATION
8F4	ABBREVIATION
Ostβ	ABBREVIATION
AKR1C3	ABBREVIATION
arginine vasopressin V2 receptor	FULL_NAME
RIM-BP3	ABBREVIATION
camitine palmitoyltransferase-1	FULL_NAME
Androgen Receptor	FULL_NAME
α7nAChR	ABBREVIATION
Scce	ABBREVIATION
Androgen receptor	FULL_NAME
Gonadotropin releasing hormone receptor	FULL_NAME
BK channel	FULL_NAME
CD81	ABBREVIATION
CD80	ABBREVIATION
interleukin 18	FULL_NAME
glucagon receptor	FULL_NAME
CaMKIV	ABBREVIATION
15-LO	ABBREVIATION
IL-27	ABBREVIATION
Factor Xa	FULL_NAME
Rnf184	ABBREVIATION
MPO	ABBREVIATION
p53	ABBREVIATION
BAFF-R	ABBREVIATION
fak	ABBREVIATION
PspA	ABBREVIATION
dipetidyl peptidase IV	FULL_NAME
axl	ABBREVIATION
SCN9A	ABBREVIATION
Na+/H+ exchanger type 3	FULL_NAME
17beta-HSD2	ABBREVIATION
cholesterol ester transfer protein	FULL_NAME
Nav 1.7	ABBREVIATION
IL-15	ABBREVIATION
IL-13	ABBREVIATION
vanilloid 4 receptor	FULL_NAME
Plasminogen activator inhibitor-1	FULL_NAME
IL-10	ABBREVIATION
p65	ABBREVIATION
amyloid beta	FULL_NAME
RXRa	ABBREVIATION
IL-18	ABBREVIATION
Glucokinase	FULL_NAME
bruton's tyrosine kinase	FULL_NAME
Al adenosine receptor	FULL_NAME
gonadotropin releasing hormone	FULL_NAME
EspA	ABBREVIATION
flt-1	ABBREVIATION
CaSR	ABBREVIATION
NK1 receptor	FULL_NAME
EGF-R	ABBREVIATION
dopamine d4 receptor	FULL_NAME
neutrophile elastase	FULL_NAME
NDRG2	ABBREVIATION
Nid1	ABBREVIATION
glycine transporter 1	FULL_NAME
glycine transporter 2	FULL_NAME
myelin-associated glycoprotein	FULL_NAME
hYAK1	ABBREVIATION
NF-YA	ABBREVIATION
ρi3κ p110 delta	FULL_NAME
Cyp11a1	ABBREVIATION
PGC-1	ABBREVIATION
kinesin-like 1	FULL_NAME
VEGF-R2	ABBREVIATION
11b-HSD1	ABBREVIATION
A130040M12Rik	ABBREVIATION
Hook1	ABBREVIATION
aromatase	FULL_NAME
cathelicidin	FULL_NAME
VDR	ABBREVIATION
catechol-O-methyl transferase	FULL_NAME
HEL-215 protein	FULL_NAME
NCX1	FULL_NAME
PTHR1	ABBREVIATION
IL2	ABBREVIATION
CaMKII	ABBREVIATION
hsp90	ABBREVIATION
rage	ABBREVIATION
Let-7i microRNA	FULL_NAME
cystic fibrosis transmembrane conductance regulator	FULL_NAME
tumor necrosis factor (TNF) alpha	NESTED
cg10823	ABBREVIATION
MTP	ABBREVIATION
1-type 11beta-hydroxysteroid dehydrogenase	FULL_NAME
histamine H3-receptor	FULL_NAME
p2ry5	ABBREVIATION
p97	ABBREVIATION
NKkB	ABBREVIATION
11 βHSD1	ABBREVIATION
Aβ	ABBREVIATION
insuline	FULL_NAME
ß2 adrenergic receptor	FULL_NAME
GSK3P	ABBREVIATION
vascular endothelial cell growth factor-2 receptor	FULL_NAME
prepro-neuropeptide Y	FULL_NAME
IGFBP-3	ABBREVIATION
β2-adrenergic receptor	FULL_NAME
Shigella ipad protein	FULL_NAME
LTC4 Synthase	FULL_NAME
GCN2	ABBREVIATION
GSK-3 alpha	ABBREVIATION
GSK3a	ABBREVIATION
Axin	FULL_NAME
TACE	ABBREVIATION
CIP2A	ABBREVIATION
muscarinic m4 receptor	FULL_NAME
tartrate-resistant acid phosphatase	FULL_NAME
MUT	ABBREVIATION
estrogen receptors	FULL_NAME
microRNA-140-5p	ABBREVIATION
nf-kb	ABBREVIATION
TACI	ABBREVIATION
VGF	ABBREVIATION
fat-1	ABBREVIATION
osteoprotegerin	FULL_NAME
Neu-T	ABBREVIATION
Ltf	ABBREVIATION
adiponectin	FULL_NAME
c-KIT	ABBREVIATION
smac	ABBREVIATION
c-erbB-2 gene	FULL_NAME
d-amino acid oxidase	FULL_NAME
11β-HYDROXYSTEROID DEHYDROGENASE TYPE I	FULL_NAME
interleukin-11	FULL_NAME
urotensin ii receptor	FULL_NAME
nf- kappab	ABBREVIATION
hepatocyte growth factor	FULL_NAME
5-HT1A	ABBREVIATION
sag	ABBREVIATION
5-HT1B	ABBREVIATION
5-HT1D	ABBREVIATION
IGF-1R	ABBREVIATION
insulins	FULL_NAME
caspase-5	FULL_NAME
IL-6R	ABBREVIATION
Murine double mutant binding protein	FULL_NAME
estrogen receptor	FULL_NAME
EGF	ABBREVIATION
DGAT	ABBREVIATION
SOCS	ABBREVIATION
kras	ABBREVIATION
NHE3	ABBREVIATION
neurokinin 1(NK-1) receptor	NESTED
SOD1	ABBREVIATION
casein kinase 1 delta	FULL_NAME
Fibroblast Activation Protein	FULL_NAME
ship2	ABBREVIATION
PAR2	ABBREVIATION
PAR1	ABBREVIATION
RAF	ABBREVIATION
5-HT2B	ABBREVIATION
5-HT2C	ABBREVIATION
lysophosphatidic acid (LPA) receptor	NESTED
chorionic gonadotropin	FULL_NAME
neurotrodhin 3	FULL_NAME
Heparin-Binding Epidermal Growth Factor-Like Growth Factor	FULL_NAME
fkbp	ABBREVIATION
cb2 receptor	FULL_NAME
Bfl-1	ABBREVIATION
5-HT2A	ABBREVIATION
calcium sensing receptor	FULL_NAME
ep4 receptor	FULL_NAME
human proinsulin	FULL_NAME
serum amyloid A	FULL_NAME
RANTES	ABBREVIATION
urat1	ABBREVIATION
O6-alkylguanine-DNA alkyltransferase	FULL_NAME
mutant superoxide dismutase 1	FULL_NAME
indole-3-glycerophosphoric acid synthetase	FULL_NAME
beta2-adrenergic receptor	FULL_NAME
A1 Adenosine Receptor	FULL_NAME
NMDA NR-2B	ABBREVIATION
MYC	ABBREVIATION
bax	ABBREVIATION
CYP1B1	ABBREVIATION
NPY5	ABBREVIATION
A beta peptide	FULL_NAME
thromboxane	FULL_NAME
RBP	ABBREVIATION
PDE 5	ABBREVIATION
Bleomycin hydrolase	FULL_NAME
Oxytocin Receptor	FULL_NAME
angiotensin receptor type-2	FULL_NAME
lfa-3	ABBREVIATION
Tfpi	ABBREVIATION
transcription factor AP-1	FULL_NAME
bFGF	ABBREVIATION
Human Immunodeficiency Virus (HIV) reverse transcriptase	FULL_NAME
cannabinoid CB1 receptor	FULL_NAME
zonulin	FULL_NAME
AAT	ABBREVIATION
phosphorylated STAT3	FULL_NAME
NS3 helicase	FULL_NAME
lincRNAs	ABBREVIATION
hdac1	ABBREVIATION
hdac2	ABBREVIATION
hdac3	ABBREVIATION
receptor for advanced glycation end-products	FULL_NAME
PDE V	ABBREVIATION
11ß-HSD1	ABBREVIATION
frizzled related protein	FULL_NAME
5ht4	ABBREVIATION
ABL	ABBREVIATION
c-KIT KINASE	FULL_NAME
5ht6	ABBREVIATION
NF-kappa B	ABBREVIATION
Survival Motor Neuron (SMN) gene	NESTED
PKCbeta	ABBREVIATION
s1p3	ABBREVIATION
AuroraB	FULL_NAME
Prolactin	FULL_NAME
MIP-1α	ABBREVIATION
acetylcholine esterase	FULL_NAME
CHST15	ABBREVIATION
Microrna-140-5p	ABBREVIATION
B-RAF	ABBREVIATION
rev-erb	ABBREVIATION
ACE	ABBREVIATION
Nk-1	ABBREVIATION
cPLA2	ABBREVIATION
neuronal nitric oxide synthase	FULL_NAME
eIF-5A	ABBREVIATION
cytochrome P450 2A6	FULL_NAME
BRAF	ABBREVIATION
s1p1	ABBREVIATION
dHGF	ABBREVIATION
plasminogen	FULL_NAME
SLC6A6	ABBREVIATION
tumor necrosis factor	FULL_NAME
LH-RH	ABBREVIATION
ITK	ABBREVIATION
S1P3	ABBREVIATION
coagulation factor ixa	FULL_NAME
PPAR α	ABBREVIATION
leukotriene a4 hydrolase	FULL_NAME
PPAR γ	ABBREVIATION
ITPKb	ABBREVIATION
galectins-3	FULL_NAME
indoleamine 2, 3-dioxygenase	FULL_NAME
ccr-3	ABBREVIATION
GSK-3 beta	ABBREVIATION
Jak3	ABBREVIATION
mouse Stra13	ABBREVIATION
Smoci	ABBREVIATION
survivin	FULL_NAME
peptidyl deformylase	FULL_NAME
PACAP	ABBREVIATION
ribosomal S6kinase2	FULL_NAME
er	ABBREVIATION
BACE1	ABBREVIATION
BACE2	ABBREVIATION
GPR120	ABBREVIATION
vitronectin receptor	FULL_NAME
dopaminergic D2 receptor	FULL_NAME
peroxisome proliferator-activated receptor (PPAR) gamma	NESTED
S1P1	ABBREVIATION
E2 glycoprotein	FULL_NAME
ACTH 1-24	ABBREVIATION
insulin-like growth factor 1	FULL_NAME
tau protein kinase 1	FULL_NAME
EDG-1	ABBREVIATION
MCP-1	ABBREVIATION
histamine H3	FULL_NAME
TGF-beta 1	FULL_NAME
crth2	ABBREVIATION
monocyte chemoattractant protein-1	FULL_NAME
h1	ABBREVIATION
nuclear transcription factor AP-1	FULL_NAME
Tumor Necrosis Factor-α	FULL_NAME
iPLA2β	ABBREVIATION
corticotropin releasing factor (CRF) receptor	NESTED
kidney bean extract alpha-amylase	FULL_NAME
squalene synthase	FULL_NAME
iqgap2	ABBREVIATION
CysLT1R	ABBREVIATION
SphK2	FULL_NAME
UDP-Glucose: N-acylsphingosine glucosyl transferase	FULL_NAME
TRPC	ABBREVIATION
ERP57	ABBREVIATION
SphK1	FULL_NAME
VE-cadherin	FULL_NAME
c-Met	ABBREVIATION
BLyS	ABBREVIATION
CCL18	ABBREVIATION
dopamine D2 receptors	FULL_NAME
EDG-6	ABBREVIATION
CRH pseudo-receptor	FULL_NAME
BRD4	ABBREVIATION
phosphatidylinositol 3-kinase delta isoform	FULL_NAME
M3 muscarinic receptors	FULL_NAME
factor VIIa	FULL_NAME
Protein kinase d	FULL_NAME
EP2	ABBREVIATION
EP4	ABBREVIATION
GPR4	ABBREVIATION
protein tyrosine phosphatase (PTP)-1B	NESTED
GPR6	ABBREVIATION
AGT	ABBREVIATION
GPR8	ABBREVIATION
GABA A a5 recepto	ABBREVIATION
CatSper	ABBREVIATION
WT1 protein	FULL_NAME
VR1	ABBREVIATION
nk - 3 receptor	FULL_NAME
VR4	ABBREVIATION
insulin receptor	FULL_NAME
CDK-2	ABBREVIATION
TGF-ß	ABBREVIATION
EPO	ABBREVIATION
AT-2	ABBREVIATION
TUSC2	ABBREVIATION
alanyl aminopeptidase	FULL_NAME
DEFB103	ABBREVIATION
CYP-26	ABBREVIATION
transferrin	FULL_NAME
AT-1	ABBREVIATION
5ht1b	ABBREVIATION
5-hydroxytryptamine-6	FULL_NAME
insulin-like growth factor-1	FULL_NAME
AHR	ABBREVIATION
PKC (Protein Kinase C) beta	NESTED
PYCARD	ABBREVIATION
g protein coupled receptor 6 kinase	FULL_NAME
GM-CSF	ABBREVIATION
aurora 2	FULL_NAME
OXYTOCIN RECEPTOR	FULL_NAME
compliment proteases CIs	FULL_NAME
CB2 receptor	ABBREVIATION
bruton’s tyrosine kinase	FULL_NAME
Slfn	ABBREVIATION
ip	ABBREVIATION
midkine gene	FULL_NAME
MITF	ABBREVIATION
Insulin	FULL_NAME
leptin	FULL_NAME
peptide deformylase	FULL_NAME
cytokine receptor-like factor 2	FULL_NAME
interleukin (IL)-1beta	NESTED
VRl	ABBREVIATION
amyloid	FULL_NAME
trpv3	ABBREVIATION
KCNQ	ABBREVIATION
pigment epithelium derived factor	FULL_NAME
indoleamine-2,3-dioxygenase	FULL_NAME
NCX	FULL_NAME
NOTCH1	ABBREVIATION
GPR119	ABBREVIATION
hPNPaseold-35	FULL_NAME
NOTCH4	ABBREVIATION
fatty acid synthetase	FULL_NAME
AK4	ABBREVIATION
microsomal prostaglandin e2 synthase-1	FULL_NAME
NDM-1	ABBREVIATION
pde5	ABBREVIATION
pde7	ABBREVIATION
aminopeptidase N	FULL_NAME
Nrf2	ABBREVIATION
alpha 1d adrenergic receptor	FULL_NAME
pde4	ABBREVIATION
S100a6	ABBREVIATION
SKIP	ABBREVIATION
TNF α	FULL_NAME
GnRH	ABBREVIATION
S100a9	ABBREVIATION
S100a8	ABBREVIATION
Human Double Minute 2	FULL_NAME
Topoisomerase I	FULL_NAME
AKT	ABBREVIATION
grs proteins	FULL_NAME
A1 adenosine receptor	FULL_NAME
Beta-Amyloid	FULL_NAME
EFGR	ABBREVIATION
gnrh	ABBREVIATION
A3 adenosine receptor	FULL_NAME
CDK9	ABBREVIATION
E-selectin	FULL_NAME
PTP1B	ABBREVIATION
CDK5	ABBREVIATION
renin	FULL_NAME
estrogen-receptor	FULL_NAME
NEP	ABBREVIATION
CDK1	ABBREVIATION
Gonadotropin-Releasing Hormone	FULL_NAME
α7 nicotinic acetylcholine receptor	FULL_NAME
TNF(Tumor Necrosis Factor)- alpha	NESTED
ALK	ABBREVIATION
basic fibroblast growth factor	FULL_NAME
type-I 11β-hydroxysteroid dehydrogenase	FULL_NAME
ALT	ABBREVIATION
PTPN22	ABBREVIATION
PRDX 6	ABBREVIATION
PRDX 5	ABBREVIATION
CSAG1	ABBREVIATION
protein kinase C iota/lambda	FULL_NAME
CD11b	ABBREVIATION
microsomal prostaglandin E2 synthase-1	FULL_NAME
N-methyl-D-aspartate receptor NR1 subunit	FULL_NAME
alpha 7 Nicotinic Acetylcholine Receptor	FULL_NAME
Bcl-XL	ABBREVIATION
TGF-s	ABBREVIATION
CYP17	ABBREVIATION
Human vanilloid receptor VR3	FULL_NAME
glutathione reductase	FULL_NAME
S1P5 receptor	FULL_NAME
Dopamine 3 (D3)    Receptor	FULL_NAME
edg2	ABBREVIATION
edg1	ABBREVIATION
protein kinase RNA-like endoplasmic reticulum kinase	FULL_NAME
NGF	ABBREVIATION
formyl peptide receptor like-1	FULL_NAME
Met	ABBREVIATION
gaba a alpha 5	ABBREVIATION
GLP-1 receptor	FULL_NAME
mu opioid receptor	FULL_NAME
pi3kbeta	ABBREVIATION
Peroxisome Proliferator Activated Receptor Alpha	FULL_NAME
syndecan-2	FULL_NAME
hepatitis C virus (HCV) NS3-NS4A protease	FULL_NAME
OCIF	ABBREVIATION
CB1 receptors	FULL_NAME
bfl-1	ABBREVIATION
EthR	ABBREVIATION
FRAP	ABBREVIATION
Glucagon receptor	FULL_NAME
adenosine A2a receptor	FULL_NAME
pik3ca	ABBREVIATION
wrap53	ABBREVIATION
PARP-1	ABBREVIATION
DP-IV	ABBREVIATION
11Beta-HSD1	ABBREVIATION
CUL4A	ABBREVIATION
NIK	ABBREVIATION
5-Ht6	ABBREVIATION
RAD51	ABBREVIATION
APC	ABBREVIATION
11-beta hydroxysteroid dehydrogenase type I	FULL_NAME
kv3.3	ABBREVIATION
mtor	ABBREVIATION
arginine vasopressin V1b receptor	FULL_NAME
INSM1	ABBREVIATION
ppar-alpha	ABBREVIATION
activated protein C	FULL_NAME
APN	ABBREVIATION
SARS coronavirus 3CL proteinase	FULL_NAME
APP	ABBREVIATION
FAAH	ABBREVIATION
taar1	ABBREVIATION
H3 receptors	FULL_NAME
DPP-4	ABBREVIATION
dopamine type 2 (D2) receptors	NESTED
estrogen recepto	FULL_NAME
AP-1	ABBREVIATION
HGFs	ABBREVIATION
cftr	ABBREVIATION
hmg-coa reductase	FULL_NAME
topoisomerase II	FULL_NAME
H3-receptor	FULL_NAME
NK3	ABBREVIATION
microrna-185	ABBREVIATION
apolipoprotein b	FULL_NAME
hs-CRP	ABBREVIATION
PPAR-γ	ABBREVIATION
phosphodiesterase 10	FULL_NAME
α-glucosidase	FULL_NAME
UDP-glucose: N-acylsphingosine glucosyltransferase	FULL_NAME
HGFR	ABBREVIATION
RUNX3	ABBREVIATION
pdk1	ABBREVIATION
CYP 17	ABBREVIATION
fsh receptor	FULL_NAME
neutrophil elastase	FULL_NAME
ARG	ABBREVIATION
PDE10	ABBREVIATION
kdr	ABBREVIATION
Dipeptidyl Peptidase-IV	FULL_NAME
Thbs1	ABBREVIATION
apolipoprotein B	FULL_NAME
heme binding protein 1	ABBREVIATION
adenosine A1	FULL_NAME
RXRγ	ABBREVIATION
RXRα	ABBREVIATION
Dhx9	ABBREVIATION
OX40L	FULL_NAME
interleukin-2 inducible tyrosine kinase	FULL_NAME
tlr7	ABBREVIATION
elastin	FULL_NAME
ASC	ABBREVIATION
mammalian target of rapamycin	FULL_NAME
Renin	FULL_NAME
chordin	FULL_NAME
cMet	ABBREVIATION
Trp-m8	ABBREVIATION
ApoE	ABBREVIATION
Rv3790	ABBREVIATION
AT1	ABBREVIATION
AT2	ABBREVIATION
androgen receptors	FULL_NAME
HSP90	ABBREVIATION
AST	ABBREVIATION
human transketolase like-1 gene	FULL_NAME
Aha1	ABBREVIATION
c-Abl	ABBREVIATION
OSTalpha	ABBREVIATION
wt1 peptide	FULL_NAME
IR1B4	ABBREVIATION
CatSper1	ABBREVIATION
HIV Nef protein	FULL_NAME
Abeta	ABBREVIATION
irs-1	ABBREVIATION
5-hydroxytryptamine 3 (5HT-3) receptor	NESTED
human GPR39	ABBREVIATION
INSP152	ABBREVIATION
GLUT4	ABBREVIATION
IR1B1	ABBREVIATION
ATR	ABBREVIATION
tissue factor	FULL_NAME
Huntingtin	FULL_NAME
Aβ-peptide	FULL_NAME
sodium-dependent glucose cotransporter 2	FULL_NAME
FMR1NB	ABBREVIATION
miR-556-5p	ABBREVIATION
Beta1-epinephrine receptor	FULL_NAME
SCCE	ABBREVIATION
cathepsin S	FULL_NAME
Telomerase	FULL_NAME
cathepsin K	FULL_NAME
DP IV	ABBREVIATION
cathepsin D	FULL_NAME
cathepsin C	FULL_NAME
cathepsin B	FULL_NAME
casein kinase 1 epsilon	FULL_NAME
cd38	ABBREVIATION
μ-opioid receptor	FULL_NAME
hIGF-II	ABBREVIATION
janus tyrosine kinase 3	FULL_NAME
intestinal α-glucosidase	FULL_NAME
PDGF-R	ABBREVIATION
SGK1	ABBREVIATION
bovine serum albumin	FULL_NAME
Camp	ABBREVIATION
alpha1 type IV collagen	FULL_NAME
TNXB	ABBREVIATION
TOMM40	ABBREVIATION
syk	ABBREVIATION
CXCR4	ABBREVIATION
NPM	ABBREVIATION
proteinase-activated receptor 2	FULL_NAME
RelA	ABBREVIATION
miR-556-3p	ABBREVIATION
CXCR1	ABBREVIATION
CXCR3	ABBREVIATION
CXCR2	ABBREVIATION
vascular endothelial cell growth factor-2 receptors	FULL_NAME
blood clotting factor IXa	FULL_NAME
D2 receptor	FULL_NAME
NQO1	ABBREVIATION
Psoriasin	FULL_NAME
RYK	ABBREVIATION
Tumor Necrosis Factor- alpha	FULL_NAME
Purinergic (P2Y12) receptor	NESTED
adenosine A2A receptor	FULL_NAME
MARK	ABBREVIATION
SIK-kinase	ABBREVIATION
FAK	ABBREVIATION
Farnesoid x receptor	FULL_NAME
sodium-calcium exchanger	FULL_NAME
phosphoinositide 3-kinase delta	FULL_NAME
FAP	ABBREVIATION
fibromodulin	FULL_NAME
cathepsin s	FULL_NAME
glutaminyl peptide cyclotransferase	FULL_NAME
FAS	ABBREVIATION
Mps 1 kinase	FULL_NAME
SGLT	ABBREVIATION
AILIM	ABBREVIATION
human p55	FULL_NAME
TC I	ABBREVIATION
Histidine ammonia lyase	FULL_NAME
11β-hydroxysteroid dehydrogenase type I	FULL_NAME
CD300a	ABBREVIATION
Prtn3	ABBREVIATION
activated-Chk2	FULL_NAME
Mpo	ABBREVIATION
april	ABBREVIATION
citrate synthase	FULL_NAME
stearoyl-CoA desaturase	FULL_NAME
NF-:B	ABBREVIATION
C-ErbB2	ABBREVIATION
microRNA-185	ABBREVIATION
IGFR1	ABBREVIATION
PspAs	ABBREVIATION
IGF- 1 receptor	FULL_NAME
Pla2	ABBREVIATION
miR-29c	ABBREVIATION
E2 receptors	FULL_NAME
NT3	ABBREVIATION
IBAT	ABBREVIATION
NR2B	ABBREVIATION
p300	ABBREVIATION
miR-29b-1*	ABBREVIATION
SHP-2	ABBREVIATION
osteocalcin	FULL_NAME
11β-hydroxysteroid dehydrogenase type 1	FULL_NAME
Tumor Necrosis Factor	FULL_NAME
Pedf-r	ABBREVIATION
Syndecan-2	FULL_NAME
ABCG2	ABBREVIATION
Er-b	ABBREVIATION
GABA A α5	ABBREVIATION
LpxC	ABBREVIATION
IL-1beta	ABBREVIATION
metabotropic glutamate receptor 1	FULL_NAME
3-hydroxy-3-methylglutaryl-Coenzyme A reductase	FULL_NAME
JTT-1	ABBREVIATION
eIF-2α	ABBREVIATION
DPP8	ABBREVIATION
JTT-2	ABBREVIATION
DPP9	ABBREVIATION
α-galactosidase A	FULL_NAME
IKK-ß	ABBREVIATION
human growth hormone	FULL_NAME
Peroxisome Proliferator-Activated Receptor (PPAR) delta	NESTED
pde10a	ABBREVIATION
TNF- a	ABBREVIATION
HCV RNA-dependent RNA polymerase	FULL_NAME
IP3Rs	ABBREVIATION
Thymidylate Synthase	FULL_NAME
miR-27a	ABBREVIATION
peroxisome proliferator-activated receptor-alpha	FULL_NAME
niGluR5	ABBREVIATION
NICD	ABBREVIATION
Neprilysin	FULL_NAME
tau protein	FULL_NAME
nuclear transcription factor Kappa B	FULL_NAME
histamine-3 receptor	FULL_NAME
her2	ABBREVIATION
PKD1	ABBREVIATION
Aminopeptidase N	FULL_NAME
integrin αVβ3	FULL_NAME
Atrogin-1	FULL_NAME
IFN-Gamma	ABBREVIATION
Kv3.3	ABBREVIATION
Cytochrome P450 2A6	FULL_NAME
HGF cDNA	FULL_NAME
EGFL7	ABBREVIATION
TNF-α converting enzyme	FULL_NAME
ABCC1	ABBREVIATION
NFκB	ABBREVIATION
PDE4D	ABBREVIATION
tau	FULL_NAME
K17	ABBREVIATION
K16	ABBREVIATION
cb2	ABBREVIATION
Eg5	ABBREVIATION
cb1	ABBREVIATION
Fp receptor	FULL_NAME
H2 receptor	FULL_NAME
cd117	ABBREVIATION
nNOS	ABBREVIATION
SAG	ABBREVIATION
trpa1	ABBREVIATION
peroxisome proliferator activated receptor-α	FULL_NAME
ceruloplasmin	FULL_NAME
HIV integrase	FULL_NAME
β3-adrenoceptor	FULL_NAME
mutant superoxide dismutase-1 gene	FULL_NAME
CxCR3 chemokine receptor	FULL_NAME
ACAT	ABBREVIATION
11beta-hydroxysteroid dehydrogenase type I	FULL_NAME
a2ar	ABBREVIATION
Int	ABBREVIATION
TGF (Transforming Growth Factor) beta 1	FULL_NAME
adenosine a2a receptor	FULL_NAME
tumor necrosis factor alpha	FULL_NAME
human thyrotropin receptor	FULL_NAME
Dectin-1 receptor	FULL_NAME
cyr61	ABBREVIATION
5HT2c-selective serotonin receptor	FULL_NAME
neurotrophin 3	FULL_NAME
beta1-epinephrine receptor	FULL_NAME
c-kit	ABBREVIATION
muc1	ABBREVIATION
emmprin	ABBREVIATION
steroid sulphatase	FULL_NAME
VLA-4	ABBREVIATION
O6-alkylguanine-dna alkyltransferase	FULL_NAME
TSHR	ABBREVIATION
cbp	ABBREVIATION
cd4	ABBREVIATION
fibronectin	FULL_NAME
TNF-α	ABBREVIATION
15-hydroxy-prostaglandin dehydrogenase	FULL_NAME
SCD	ABBREVIATION
Raf	ABBREVIATION
telomerases	FULL_NAME
hypoxia-inducible factor-1	FULL_NAME
CB receptor	FULL_NAME
Tnfaip3	ABBREVIATION
